CALL	K AO L
CHANGE	CH EY N JH
EMAIL	IY M EY L
ERASE	IH R EY S
ERASE(2)	IY R EY S
GENDER	JH EH N D ER
HISTORY	HH IH S T ER IY
HISTORY(2)	HH IH S T R IY
LOG	L AO G
MARK	M AA R K
NAME	N EY M
NEW	N UW
NEW(2)	N Y UW
OUT	AW T
PASS	P AE S
PHONE	F OW N
SEARCH	S ER CH
SEND	S EH N D
SEVEN	S EH V AH N
SURNAME	S ER N EY M
USER	Y UW Z ER
VIDEOCALL	V IH D IY OW K AO L
